  #####
###   #
# $ # ##
# #  @ #
#    # #
## #   #
 #   ###
 #####