  #####
###$  #
# $ # ##
# #  . #
#    # #
## #  *#
 #@  ###
 #####