;
 
;
#
;
 #####
####  #
#     #
# $## ##
##      #
##    # #
#     . #
#@    ##
#######
;
 #####
####  #
#     #
# $## ##
##      #
##    # #
#       #
#@    ##
#######
;
 #####
####  #
#     #
# $## ##
##      #
##    # #
#.    . #
#@    ##
#######
;
 #####
####  #
#     #
# $## ##
##      #
##    # #
#     . #
#     ##
#######
;
 #####
####  #
#     #
# $## ##
##      #
##$   # #
#     . #
#@    ##
#######
;
 #####
####  #
#     #
# $## ##
##  x   #
##    # #
#s    . #
#@    ##
#######
;
 #####
####  #
#     #
#  ## ##
##      #
##    # #
#     . #
#@    ##
#######
;
 #####
####  #
#     #
# $## ##
## @    #
##    # #
#     . #
#@    ##
#######