  #####
###   #
# $ # ##
#s#x . #
#    # #
## #   c
 #@  ###
 #####